100000000000000000000000000000000000000000000000000000001
100000000000011111110001111111100000000000000000300000001
100000000001110000000000000000000000000110000000100000001
100000000000000000000011110110011110001100000001110000001
100000111111000000001000000001100000011111111111110100001
100000000000001000011000000000000003110000000001110100001
100000000011001000111100000001000001010010001001111100031
100000000000000001100001000011000010000000000001111110111
100000000000001111000111000111000100000000000000000000001
100001111110000000030000010000001000000000000000000000001
110010000001110000010000110000010000000000000000100000001
111000000000000000101000000003100000000900000001110000001
111000111111000001000100000031000000001111111111110100001
111100000000001010000010000010000000010000000001110100001
111110000000011100000001000000000000017010001001111100001
111111111111111111111111111111111111111111111111111111111
