100000000000000000000000000000000000000000000000000000001
100000000000011111110001111111100000000000000000300000001
100000000001110000000001000000100000000110000000100000001
100000000000000000000011110110011110001100000001110000001
100000111111000000001000000001100000011111111111110100001
160000000000001000011000000000000003110000000001110100001
160000000011001000111100007001000001010010001001111100031
160000000000000001100001000011000010000000000001111110111
160000000000001111000111000111000100000000000000000000001
160001111110000000030000010000001000000000000000000000001
116010000001110000745500110000010000000000000000100000001
111000000000000000101550000003100000000000000071110000001
111000111111000001000150000031000000001111111111110100001
111100000000001010000017000010007000010000000001110100091
111110000000011100000001720000000000710010001001111130011
111111111111111111111111111111111111111111111111111111111
