100000000000000000000000000000000000000000000000000000001
100000000000000000000000000000000000000000000000000000001
100000000000000000000000000000000000000000000000000000001
100000000000000000000000000000000000000000000000000000001
100000000000000000000000000000000000000000000000000000001
100000000000000000000000000000000000000000000000000000001
100000000000000000000000000000000000000000000000000000001
100000000000000000001111111111111000000000000000000000001
100000000000000000001100000000011000000000000000000000001
100000000000000000001100000000011000000000000000000000001
100000000000000000001100000000011000000000000000000000001
100000000000000000001100002000011000000000000000000000001
100000000000000000001111111111111000000000000000000000001
100000003000000000000000000000000000000000000000000000001
145678900000000000000000000000000000000000000000000000001
111111111111111111111111111111111111111111111111111111111